6 Years after first being detained by doctors because of the 2006 incident where you attempted to banish satan (a 10 year old trick or treater) away from this earth, and back to the hell, it is 2012 and you must escape and return to heaven before the almighty father wipes the earth clean over in order to erase all evil.

HI IM JESUS
An Interactive Fiction by Roboninja101
Release 1 / Serial number 141024 / Inform 7 build 6L38 (I6/v6.33 lib 6/12N) SD

Your Cell
You look around your mental ward, sitting on your worn out bed, and notice a dresser, a mirror, and your cell door to the east.

You can see Cell Door here.

>take shard
Taken.

>open matress with shard
That doesn't seem to be something you can unlock.

>take all
FUCKING FAGGOT, TRYING TO HACK IN MY GAME! I GET BET YOU USE AIMBOT AND GODMODE IN COD TOO!

* * *

>take all
bro, really? i hope you feel good about yourself trying to hack.

>take shard
Taken.

>open matress
Using that sharp glass shard from the mirror, you plunge the shard deep into the mattress cover and tear it open,

>open mattress
Using that sharp glass shard from the mirror, you plunge the shard deep into the mattress cover and tear it open,

* * *

>x mirrow
You can't see any such thing.

>x mirror
You look into the cracked, bloody mirror and see your reflection.

You see a glass shard and pick it up.

>open matress
Using that sharp glass shard from the mirror, you plunge the shard deep into the mattress cover and tear it open, and grab a bed spring.

* * *

>x mirror
You look into the cracked, bloody mirror and see your reflection.

You see a glass shard and pick it up, realizing that is could potentially cut things.

>cut mattress with shard
I only understood you as far as wanting to cut mattress.

>open mattress with shard
That doesn't seem to be something you can unlock.

>open mattress
Using that sharp glass shard from the mirror, you plunge the shard deep into the mattress cover and tear it open,

>i
You are carrying:
  Bed spring
  Glass Shard

>open mattress
Using that sharp glass shard from the mirror, you plunge the shard deep into the mattress cover and tear it open,

* * *

>x mirror
You look into the cracked, bloody mirror and see your reflection.

You see a glass shard and pick it up, realizing that is could potentially cut things.

>open bed
(Bed)
It isn't something you can open.

>open mattress
Using that sharp glass shard from the mirror, you plunge the shard deep into the mattress cover and tear it open, and grab a bed spring.

>open mattress
Using that sharp glass shard from the mirror, you plunge the shard deep into the mattress cover and tear it open, and grab a bed spring.

>x mirror
You look into the cracked, bloody mirror and see your reflection.

>open mattress
Using that sharp glass shard from the mirror, you plunge the shard deep into the mattress cover and tear it open, and grab a bed spring.

I beg your pardon?

I beg your pardon?

* * *

>x mirror
You look into the cracked, bloody mirror and see your reflection.

You see a glass shard and pick it up, realizing that is could potentially cut things.

>take shard
Taken.

>cut mattress with shard
I only understood you as far as wanting to cut mattress.

>cutt matress with glass shard
That's not a verb I recognise.

>cut mattress with glass shard
I only understood you as far as wanting to cut mattress.

>open matress with shard
x

* * *

>x mirror
You look into the cracked, bloody mirror and see your reflection.

You see a glass shard and pick it up, realizing that is could potentially cut things.

>open mattress
Using that sharp glass shard from the mirror, you plunge the shard deep into the mattress cover and tear it open, and grab a bed spring.

>open door with bed spring
after picking at the lock with that bed spring for a few minutes, you hear a click and the door unlocks.

>e
(first opening Cell Door)

Hospital hallway
White lights blind you as you look around the hallway. you notice an exit to the north.

You can see Cell Door here.

>w
Your Cell
You look around your mental ward, sitting on your worn out bed, and notice a dresser, a mirror, and your cell door to the east.

You can see Cell Door here.

>e
Hospital hallway
White lights blind you as you look around the hallway. you notice an exit to the north.

You can see Cell Door here.

>e
You can't go that way.

>e
You can't go that way.

>ew
That's not a verb I recognise.

>w
Your Cell
You look around your mental ward, sitting on your worn out bed, and notice a dresser, a mirror, and your cell door to the east.

You can see Cell Door here.

>w
You can't go that way.

>e
Hospital hallway
White lights blind you as you look around the hallway. you notice an exit to the north.

You can see Cell Door here.

>w
Your Cell
You look around your mental ward, sitting on your worn out bed, and notice a dresser, a mirror, and your cell door to the east.

You can see Cell Door here.

* * *

>e
Hospital hallway
White lights blind you as you look around the hallway. you notice an exit to the north.

You can see Cell Door here.

>n
Hospital Entrance
The courtyard in front of the Hospital is actually quite beautiful, especially when you're not stuck in the inside of it. The hospital entrance is to the south, and there's a road and sidewalk to the north.

>n
East Sidewalk
a sidewalk running next to a very busy street. it probably wouldnt be a good idea to cross the street without a crosswalk. the street is to the north, and the sidewalk leads further to the west.

>n
You take about three steps out onto the road, and you get blindsided by a bus and die upon impact. Didnt your mother ever teach you to look both ways before crossing?

    *** The End ***

Would you like to RESTART, RESTORE a saved game, QUIT or UNDO the last command?

>restore
Restore failed.

Would you like to RESTART, RESTORE a saved game, QUIT or UNDO the last command?

>undo
East Sidewalk
[Previous turn undone.]

>w
west sidewalk
a sidewalk running next to a very busy street. it probably wouldnt be a good idea to cross the street without a crosswalk. A crosswalk is to the north, and East sidewalk is to the east.

>n
Crosswalk
Theres nothing like the safety of a sidewalk. could you imagine what might happen if you tried to cross this road without a crosswalk?

* * *

>open mattress
Using that sharp glass shard from the mirror, you plunge the shard deep into the mattress cover and tear it open, and grab a bed spring.

>open door
It seems to be locked.

>unlock door
What do you want to unlock Cell Door with?

>bed spring
after picking at the lock with that bed spring for a few minutes, you hear a click and the door unlocks.

>e
(first opening Cell Door)

Hospital hallway
White lights blind you as you look around the hallway. you notice an exit to the north.

You can see Cell Door here.

>n
Hospital Entrance
The courtyard in front of the Hospital is actually quite beautiful, especially when you're not stuck in the inside of it. The hospital entrance is to the south, and there's a road and sidewalk to the north.

* * *

>n
East Sidewalk
a sidewalk running next to a very busy street. it probably wouldnt be a good idea to cross the street without a crosswalk. the street is to the north, and the sidewalk leads further to the west.

>w
west sidewalk
a sidewalk running next to a very busy street. it probably wouldnt be a good idea to cross the street without a crosswalk. A crosswalk is to the north, and East sidewalk is to the east.

* * *

>open mattress
Using that sharp glass shard from the mirror, you plunge the shard deep into the mattress cover and tear it open, and grab a bed spring.

>unlock cell door with bed spring
You unlock Cell Door.

>e
(first opening Cell Door)

Hospital hallway
You can see Cell Door here.

>w
Your Cell
You can see Cell Door here.

* * *

>x mirro
You can't see any such thing.

>x mirror
You look into the cracked, bloody mirror and see your reflection.

You see a glass shard and pick it up, realizing that is could potentially cut things.

>cut mattress with glass shard
I only understood you as far as wanting to cut mattress.

* * *

>x bed
your bed...errr concrete slab. this is where you sleep on an old mattress where the springs poke through the cover.

>x bed
your bed...errr concrete slab. this is where you sleep on an old mattress where the springs poke through the cover.

>x mattress
Your mattress. this thing is more like a rag bag with a couple of springs stabbing you in the back everytime you lay down.

>open mattress
You grabbed the end of the mattress at the seams, and pulled as hard as you can, trying to rip it to open, but you couldnt open the mattress.

>open door
It seems to be locked.

>x mirror
You look into the cracked, bloody mirror and see your reflection.

You see a glass shard and pick it up, realizing that is could potentially cut things.

* * *

>open mattress
Using that sharp glass shard from the mirror, you plunge the shard deep into the mattress cover and tear it open, and grab a bed spring.

>unlock door with bed spring
after picking at the lock with that bed spring for a few minutes, you hear a click and the door unlocks

>e
(first opening Cell Door)

Hospital hallway
You can see Cell Door here.

>i
You are carrying:
  Bed spring
  Glass Shard

* * *

>open dresser
That's already open.

>x dresser
Dresser is empty.

>x mirror
You look into the cracked, bloody mirror and see your reflection.

You see a glass shard and pick it up, realizing that is could potentially cut things.

>cut matress
You can't see any such thing.

>cut bed
Cutting it up would achieve little.

>open mattress
Using that sharp glass shard from the mirror, you plunge the shard deep into the mattress cover and tear it open, and grab a bed spring.

>open clee door
You can't see any such thing.

>open cell door
It seems to be locked.

>unlock cell door
What do you want to unlock Cell Door with?

>i
You are carrying:
  Bed spring
  Glass Shard

>bed spring
That's not a verb I recognise.

>unlock door with bed spring
after picking at the lock with that bed spring for a few minutes, you hear a click and the door unlocks.

>n
You can't go that way.

>s
You can't go that way.

>e
(first opening Cell Door)

Hospital hallway
White lights blind you as you look around the hallway. you notice an exit to the north.

You can see Cell Door here.

* * *

>e
Hospital hallway
White lights blind you as you look around the hallway. you notice an exit to the north.

You can see Cell Door here.

>n
Hospital Entrance
The courtyard in front of the Hospital is actually quite beautiful, especially when you're not stuck in the inside of it. The hospital hallway is to the south, and there's a road and sidewalk to the north.

>n
East Sidewalk
a sidewalk running next to a very busy street. it probably wouldnt be a good idea to cross the street without a crosswalk. the street is to the north, and the sidewalk leads further to the west.

>n
You take about three steps out onto the road, and you get blindsided by a bus and die upon impact. Didnt your mother ever teach you to look both ways before crossing?  idiot...

    *** The End ***

Would you like to RESTART, RESTORE a saved game, QUIT or UNDO the last command?

>undo
East Sidewalk
[Previous turn undone.]

>i like that
I only understood you as far as wanting to take inventory.

>w
west sidewalk
a sidewalk running next to a very busy street. it probably wouldnt be a good idea to cross the street without a crosswalk. A crosswalk is to the north, and East sidewalk is to the east.

* * *

>n
Crosswalk
Theres nothing like the safety of a sidewalk. could you imagine what might happen if you tried to cross this road without a crosswalk?

>thats all i got
That's not a verb I recognise.

>ty
That's not a verb I recognise.

>try mine its on github
That's not a verb I recognise.

>ok
That's not a verb I recognise.

>wait
Time passes.

>look at this
You can't see any such thing.

>bich
That's not a verb I recognise.

>dyrus is actually pretty
That's not a verb I recognise.

>*prety tall
That's not a verb I recognise.

>ok bye
That's not a verb I recognise.

* * *

>OPEN matress
You grabbed the end of the mattress at the seams, and pulled as hard as you can, trying to rip it to open, but you couldnt open the mattress.

* * *

>e
Hospital Hallway

>w
Your Cell

* * *

>open  matress
You grabbed the end of the mattress at the seams, and pulled as hard as you can, trying to rip it to open, but you couldnt open the mattress.

>open mattress
You grabbed the end of the mattress at the seams, and pulled as hard as you can, trying to rip it to open, but you couldnt open the mattress.

* * *

>open matress
You grabbed the end of the mattress at the seams, and pulled as hard as you can, trying to rip it to open, but you couldnt open the mattress.

>i
You are carrying nothing.

* * *

>open matress
You grabbed the end of the mattress at the seams, and pulled as hard as you can, trying to rip it to open, but you couldnt open the mattress.

>take shard
Taken.